ewl: umy bel lpr kxf ges icu cjt mwh eqx nyp abp fuz uil
scp: ffj fnn oef lxa jcb xmb cfl kuq rtz tim njq tcw
lnq: ezn fuz lof nzj zsr
ipd: ocr ksi gbw xit
qak: jnr nel bia pcc egu whn
jhf: qxc rtz pbx kvi bhs qew tlp voo osb srw npq kzq
kub: lfy ppa oip esh lqd iyr bxz lpw sfn zcb kzm gtz lof
xkq: nep
urv: ewl jqy lof wkm nqt hlx dli gbv xoy bbg hul olf
zmf: fnb ewl mal xvt ylc lxa hft hgq vyh jnr ujq zkf
qag: xdo yhz pwr qew ozf udm mwh mal ydm jxm tds
xhb: jnr kmk bmq mkf vyy jbu seu awm kub tng trj gbv sdz adu ies
nlu: hmw yrs hal ffi lvu ewl pcc fnn xib ffj dly eum qxc nep
xkt: wik sou amr msg nzj qew
sfx: iib zmf cvd tcw txs kzq zoy amr yaw pgl
lst: qvc kvm scr jjq mgf eef lbx lxn pcc vaz
gct: smb jmm qag uuy tfh tcw cjf hlx jcb zat agp pys kvm cmb
erj: xit pgl zcb sdz gih qnr zmf pqu
xkl: fuz gtz xib tpj njq fnn oqv mwh lvu ppa vyh eqx nzj
lkv: rwh joo rtz lst cjt jqx xec hmw kzq sbu voo oim mgf
imz: ilc jol luf ezn
amr: xmi pcc
auw: cdj eqx por oef oib qnv ysz out jsv dwm ylc lhp cre jxm
fcm: esh jqy umy pcc sgi oqv xoy hlx
kes: cjf fwk kej
lvh: iyr cfl jqy rfx ujq osb olf rtz umy zdq oqv ges
hmw: ges jqy jol olf rfx qew uil tdd lvh mwh
nsc: bel yfj cme urw qvd adu efu cjt khr lqd qmy tng nyp puo
ygj: bri tue ksp cre lpw cme hlx xkl vgt cjf pgy ssl lhp seu imi joo
qxc: cjf ffi
mno: tlp pcj usg rdw jkh xvt nzj ecz mkf cea qvc xdo pjc zgi abp csi
cea: oib
pbw: xfs
inu: tmi joo jnr lpr spc cge tue qnr vuh vuc
nzj: rtz lpr kxf vpw xoy gxk osb qew qvd uil xib fuz
cwa: oib
jbu: sdz ova
vuc: wkm csi yav pgl wne tav ezn agl
pqu: mal cmm nuh kuq kad inu nyp osn rdw tim erz adu bbg sus vaz
uqm: yan
raa: rug hzj hdj ejd imz dwm cxd adr
joo: eef nep esh rfx
ssi: ksi tem
fgr: rpz sfn pgl tbp kes nel bsp msg efu oef qac nep bwk zgi jsj
qov: dli nbv ysz
tsz: zjj fgt sbu
jcb: hft olf qew tdd alx jih iyr mhn ujq ges fcm uil zdq jqy
uxh: pbx vzg yrs
wru: kxf fnb ewl ujq urv lof gbw kzm wkm gxk jnr qvd pgy
xvt: puo nzj tdd wne gxk lvu ges nyp uet lqd
vzg: sdz pgy puo pin rtz osb uxg ian wne pcj ygd mal
pjc: nxf cak tcw
xib: esh xqw jih
kxf: rtz mwh
kcw: wkm hmw nqt bel icu agl sbh oqv scr wne vhr brk
fqd: bbg bya
nel: lhu xvt vni pin fnn sfn joo hul olf wko eqx clp vgt
pbx: vgt sus vuc ova bhs uxg lpw kzm tue
uxg: sdz iyr eqx mwh nyp gbw wqm yrs oef jsv kuq out
xwd: lud sdz ysz ksp frc ttg bxz scp orr dwm zkf diw lrs jjq ges uil
seu: jjq fnn zsr olf osn
bsu: zdq whn ppa cge ygd imi
iig: bel fuz
kzm: kxf cge tcw fnn lfy xib sgi tpj jqy bya
xzj: tdd
fgt: ocr frc kvm fuz joo rkj ges qxc uet gbw tdx
nwu: bsp wko pfm nbv kcw wqq bqd pmn mwh agl pjc ffj hmk efj jsv cea
hlu: dre dly imi slt vzg khs
ytp: yrs
qrc: maq slh ppa ocr jxm hul
umy: rfx vpw osb jih pcc
hrh: sdz lhu vac ges cre vkl tem sus srw jsv wik usg
ass: mhn urv uet jqy hul sbh lhu qnv lxa ylc joo
kwa: tmi xac zmf bxz pcy whn lnq rtz jqx oib msg fuz ylc kej bya
tbp: oef qgm ucl nhi dli qac igo cis hyh fnb frc buj wru
rkf: cgd ijv yhz zjj tfh kwa dde fnn jxm qak lpt cwa
ria: jjq pcj jqy urv qew gbw iyr zkf orr oqv hal
ilc: zqn qxc rug hmk bzv gih brk fnl ges vfa awm ttg jcb ssl pbx tue
nyq: jgh yfz jxm
smm: uba bri qmy vuc ucl
efj: crj kcw frc txo wix ucq ssi fwk hft
ksi: ocr nel orr hdj lfy lhp iyr alx bhs vtx eum fgc
ltm: nyp upr vfa lrs nvz xgf uxg sgi vni udm
ucz: vtx srw dly ygd auz zcb cre svc oqv jmn vhr sfn eef
ffj: dwm vni nel pcc icu zkf vgt urv hgq hul xqw vfa qvd kzm
lbx: mhn
ian: gxk qew puo
wme: ksp cge slp ges mnz mlb zyu vac
rfx: jqy hlx pcc xoy oqv osb
xge: bsu msg xoy udx dli fwr ujq yfj cby fgt xwh lhp agp
you: out kmk awq xgf xfa qlo ozf ucq qac
lud: ujq svc mhn lxa jjq rfx olf xft osb vpw wkm
ozu: smm dac nvz tds tre ove vaz zxh lxa vgt qvd hgq
bel: ujq jol hmw rtz nyp iyr
pys: jsj wik iax kwa ksp oqv nvl ajr ueq jol kvi
xfs: hdj abi ajr bri nlu usg dly psr kxf fnb xit jqk nbv xgf hyh
vwu: ohc gsw wqx
udm: wne tpj zdq olf xft whn xmb mgp psr jsv pbx vpe bsw
zat: gxk lqd zcb fnl mal kuq cfh xoy wne jsv hal umy vyh fnn
pwr: vuc gbw yhz fnb mwh dbw ezn ydm uxg tmi hmw fgc ass jsv
tfh: tdd nel hez hal ivj cjf jkh pgr qlo kuq lxn orn lxa scr agl urv
qvh: uoh kca gxk hmk kvm tbp fnn bsp gbw ssi lzt
wco: usg lxa tlp gbv vtx diw srw cjt sbh kvm ttg zqn rtz cfh
bbg: bya hlx alx ujq osb jih lof fuz xqw mwh pcc olf xoy hft
tem: nyp vyh lrs ian eum svc
orr: zsr auz sdz pgl ezn tdd lqd vpe icu cge ffi xvt vfa kxf lxa
uet: pcc umy hlx wne fnl esh zcb lud ewl out
aod: pys hod pfm
tpr: lfm cjt ndn
mhk: pcj gsz tng
tds: gbv lvh olf vfa lvu lxa hft vhr joo rfx
vzn: ksp chd
rpz: vgt lnq ucq clp lfy ygj qgm vtx
kmk: gtz uxh scr dku qtn hgq wkm erj yke jmn puo scp nvz
hlx: oqv jqy
gbw: cme jol zcb tdd nxf joo bri hft xqw hmw out bbg wkm wne
qct: hul fcm zdq bxz jqy lhu tlp nep kad tds fnl xmi osb jaw bhs nzj
ste: faw agp agl orr awm voo gsw tue kej fnb wru sus zat ksi
hmk: ylc svc ppa wru hgq ujq
qyh: qrc lfy voo kgz ukr ylc gih
oqv: jqy
cvm: vni ejd ohc baa frc joo lvu xoy jbu psr qnr xsf njq tue ozf
gkm: zdq ndz dku lvh udo ejd xvt ecz
trb: kzq kwa
wlu: kmk clp xit oib rug qxc yfj srw oqv nep ksi wkm lrs zsr hul ffj
gxk: rkj tdd eef ujq ygd hmw tpj qew
pdc: qwb kvi tsz snq dre hpj
tim: wkm clp pcc uet ffi alx
azy: uet tdd jcb gbw tpj mal gxk nep kxf osn pcc ppa ksp uil lhp
adu: zxh xmb zsr fuz jqk xqw osn vgt lhp vaz
agl: csi lfy cge umy
pkt: dac
xuj: lfm you qwb pcc imz ocr tre kzq lll pfm dac kmk xqw tbp lrs
pmn: vhr zsr smm ksp gkm zyu jol faw dtu wik
usa: vaz kwa jnr orr cea kcw pcj tbp dre uuy fqd pgl rfx tfh
wec: usg ksi ltw tmi lnq txo lll sdz hft rpz zed luf uxg qag
tsf: adu qwm ysz kcw qlo luf fyi cge fwk udx
cjf: bya umy rtz nyp
bsw: alx puo ajr nyp ges jjq hft pgl auz fnn
mwh: rfx xoy vpw iyr cfl jih umy nyp fcm pcc
pyv: lnq ove pcj
lfm: pgy smm lmc fnl gqb
zoy: uet ppa
uoh: sgi out jcb vni bya cge kxf gtz fnn olf nep fnl xvt lxa urv
igo: ksp gtz jjq cre sgi nyp osb olf kzm yrs hlx out ezn joo
wko: lof tpj mwh lpr hmw fcm nep xgf bbg
qac: jhf lhp xoy rkj nqt oqv kuq ylc tmi esh dwm tcw ssi
chd: yav fnb hmw nlu ujq fqd jcb iyr gbv wkm xet fgt
tuv: oib dtl qnv fgc uet dku kcw hnt vtb cis gzu bhs seu
usg: njq fuz puo xvt eqx olf dli
vfa: jqy gbw alx tdd ova csi jcb kuq
oip: vni njq ksp sgi cme nyp joo osb rkj
txo: hul xqw erz cvm scp udx srw npq
fuz: hmw pcc ppa bel puo joo ges hlx kxf alx jjq zdq oqv
cis: psr uet ygd adu wqm ohc osb ova cfl sus ges dli
hxb: faw lbx zcb mwh kvm qmy trj xoy jmm pqu uxh puo mgf oht chd
zed: whn nlu bsu xft vfa qnv bxz
lzt: qnr jqk bbg
dgk: dku wkh csw tkv ual lll ivj vez xib hod icu
yan: xwh
fyi: tav srw ges cvt fnl qew pgl khs vpe xac ysz nbv uet fgc ian
smb: rdw faw voo wkm gxk jih rtz oip pxg zyu lhu jcb uxh pcc
eqf: cot ueq tkv spk ylr xib mal imz sgi kxf
xmi: zkf xft lxa imi urv nel dli
wqx: ole kag jqk osb grk lvu
xft: fuz xib bri xqw zsr wkm osb cfl lvu dli uil
jgh: acm cme kwa faw lxa ale ove whn pbw xmb jxm agl kxf eum jih xsf
sbu: zxh ucz jxm nep cdj umy sus
kuq: lud nep sgi nqt
vyh: bel nqt osb tdd olf cjt
pls: fga pcy luf orn hod vef kcw
slh: lst vuh xmb
wmn: sdz djh mnz ztb lpr low por pcj lvu lem
riz: cwa tdd ubp pys
tav: usg wkm vyh bel jnr svc hal qwb ylc xib
hyh: lhp clp kub ocr jjq sfn
egu: olf vzg kag tlp rpz pxg lqd vyh
ubp: xec nlu uoh sus ole xvt gxk scp lvu ssl bsw xkl cfl hlx
bhs: urv olf abp eef esh jjq lqd
qwb: xmi lhp bxz
vbj: lpw wik fnn uil wkm lvh pcj wqq evd igo npq csw zxh tdd
erz: frc srw hmw pog uxg wne lhu
sdt: wlu pcj csw bya
fnb: xgf
xmb: hgq rfx xmi ppa ttg cge lpw dly fgc hlx tav
diw: psr
yav: wkm bxz kzq oip zcb vpe olf seu hdj dwm mhn tav ian nel lfy
luf: ydm qew vyh qnr iyr vpw tcw wko ylc
bri: cme
yrx: ymk ozu dly ual ove dli tdx vhr uil kad jcb usa
iyr: ges sgi jqy eef rtz rfx fcm tdd zdq oqv hlx
iax: ova xmi oht pqu wkh rfx kvi inu scr ndn qvd kag cge zqn bia ppa
fnn: uil oqv xgf fnb mwh olf rtz cre ffi
jje: olf vzg jqk yhz lrs tav cfl ssl hft ffi csw jaw vuc vni sfn
ges: vpw cfl rfx tdd sgi jih umy jqy pcc oqv esh osb xoy fcm hlx
zjj: bel cmb nhi mnz
low: iby ezn
law: nhi qnv lud chd tuu qac xfa
rug: bbg
uil: oqv sgi tdd rfx ges jih zdq vpw pcc hlx esh fcm osb rtz eef jqy
xac: qvd lpw joo
rtz: xoy jih fcm cfl hlx sgi umy
efu: ltw luf sjq faw
ssl: ygd cfl lof wqm xib lhp ppa bel icu
lrs: ass dly fuz
crj: hdj erz hft rjd hmw dxe
xfa: tyq kzm
iib: awq erz ffj cvm
mkd: jgh cxd egu bzv tkv out yrx osn sdt djh wbi
ksp: joo fnl csi oqv osb gtz
mkf: esh abp orn cgd zsr jxm iax tyq tpj zoy yke
osn: gbw wne nzj zsr hmw joo cfl ezn xvt
mhn: bel ges osb fcm jqy nyp rkj olf rtz hlx zdq ujq eef esh nep mwh
jsv: vgt zcb yrs bya rfx xqw csw fnl nbv umy xkl nxf ppa bri jih icu
qlo: amr ges zdq zlo ual ubp
ujq: ges esh olf jol osb
wqq: ozf
lll: cgd pcy nvz nxf llg law tlp xft gsw vbj
jmm: ejd mlb tpj ysz fcm zmf tcw ecz oef ygj nlu qnr imi lvu jaw
slt: lnq wkh rdw xkt bhs lvu jjq dku umy jol jhf pgl pcy igo
lvu: cfl umy olf vyh svc lof jjq osb vpw gbv bel dli bya nqt fcm mhn
ezn: xib uil lud pcc urv lof
tvv: xyk you dly vuc
hft: mwh zcb qew oqv sgi cfl ppa ffi mhn lof abp
scr: ttg tcw vtx uet tdd gbv jjq hft umy ffi jqk maq rkj ewl
csw: ffi nxf qew xkl mal ppa awm bbg csi ksp sfn cjf iyr
ueq: kzq joo wqm ksi tpj
rwh: lpw icu kuq ian ova zdq dly tue svc lpr dwm nel hlx olf hmw nqt
grk: pog agp jsv cis fgt jhh
lhu: wkm tpj osb eef jjq clp hul gbv mhn rkj
psz: sfn jeg bya crj rwh csw bel adu icu tdx oef inu
qtv: sbh ysz qnv bwk tue awm bri evd hyh lst you
hpj: zkf dgk crt zsr xaf oim xit buj qov zxh
jjq: umy uil lpr eef vpw joo qew cfl hmw tdd xoy iyr
ajr: ppa wik ucq qew
wkm: cjt ewl sgi fnn abp
tdd: oqv osb vpw pcc
ymk: nep puo ewl out sdz jnr xmi auz
faw: ssl nep jsj bxz jsv vuh clp out ffi rfx auz qwb pgy ttg
qpc: voo ues urv wqm mlb lnq xec nxf
bya: jih iyr joo osb mwh hmw uil ges
yfz: vpe kvi umy tuu
pgy: puo ppa xgf oqv cre fcm cme esh awm icu hlx olf bel jqy
dtu: hrh yav qlo xge ucz ylc ewl lhp ozu ges vhr xvt vuc imz xec ttg
cdj: lbx ajr oip jcb wkm nbv oqv mhn qnv nel pcy hmw
spw: zyu vuc gkm ecz lfm smm cfh sus psr tbp mlb
ylr: ppa
upr: hmw
vhr: bel pgy lhu tpj jqy
ues: ttg ole
tyq: sdz gzu
snq: jjq tlp olf zqn khr srw lfy dwm
imi: xkl fuz joo rfx iyr oqv csi zsr
sbh: lqd
pcy: hft tlp xft fuz scp ajr cge oqv xkl fcm osb qvd uil xmi tdx ffj
eef: jqy oqv esh xoy zdq jih cfl fcm ges
vyy: bya bng dku qxc zqn gzu ipd zkf jbu
voo: pcj whn hlx
ual: ytp cfh jxm ssl hmw ueq jih hdj fgc abp icu njq osn
dtl: kmk ecz
knr: urv lbx qlo hft wkm ucz spw tbp ole egu wik pgl
spk: lvu hrh lhp chd brk esh ytp xwh olf diw gbv ria lpr kvm lqd kej
dxe: tue lnq
vep: dde yrs lll yfj xmb trb vyh wco udm tdd ksp pys ian rug fgt ria
yke: lpr
rdw: nbv
wcz: vhr fft udo
khs: nhi jmm puo kxf
jsj: esh bri wkm pcc jol wko
sfn: psr out urv
trj: alx tre maq tpj iig jqy hft vtx whn jnr
nwp: grk fnt fzw ydm usg azj cgd ezn urv jmn faw gnq gkm svc seu csi
rjd: orn ylc acm oef udx qvd eef auw wko jje iax
fyw: jsv
crt: jhf jbu vez lnq ies adr buj vfa wqq eef cot snq
kag: buj pog csw zsr
sdz: icu qnv gbw lpr tpj lfy jqy lxa jnr oip vpe hmw
svc: hft ffi fnn xoy
dcf: luf nyq
lxa: vyh vpw awm xqw abp zdq kxf
ffh: bsu ove eum yav
bia: ksp vhr tpj brk xkl xec baa jjq msg snq ffj cdj qgm
cme: abp tdd mwh fnl ujq hlx lpr jih fnn iyr zdq cfl vpw pcc cre cjt
bmq: lnq pmn nvz wne qov spw spc awq smm ssi wru kca cvd
ohh: ygd sbu eum csw ksp tav sbh vzn
tlp: hmk pog kad
rwc: cfh khs uxg wkm out msg kuq agl eqx hrh nvl tds vac cjf pqu
xgf: hmw jjq qew
buj: xft xqw
xyk: kag tav faw ezn jol uil cre xwd mwh fnn oip sfn ajr igo wru tem
xsf: buj faw
osb: oqv hlx pcc
lct: npq bsw rdw uba fgc hmk osb ygd icu uet cjt chd jje nzj ewl iyr
kad: zkf vpw wru dly
iby: ytp kzm ozf
adr: nhi pys eef pgy zmf clp vyh xfs tav lxn fnn cot oim
spc: xgf amr imi ydm orr vpw ygj pgy jmn wko
bxz: vfa ova lhu wkm out uet igo lfy
qmy: snq seu qwb vtx jaw nel jol diw tav zqn cby
gtz: icu qew fcm awm oqv fnb tdd hmw ges tpj gxk cfl olf wkm nep
bqd: hmw ndz csi xwh dbw lhu sdz qnv mhn
zwx: jsj xib xoy kub udm jbu zkf vhr ezn
ewn: zcb ove jol cfh gtz xvt bqd tjj cby lpt pog vbj oip
cvd: cot wko bsu mwh pcc iig qew vpe kuq bsw tav bxz zxh nel
cak: qxc jih lst fcm ucl lpr xmi bia jsv
cge: gxk umy xgf pcc fuz abp ges oqv wkm hft dli jqy fnl ygd kxf ujq
sus: nbv ymk xqw hyh zat frc cfh ova
rau: msg ass svc uxg jmn wne wco bhs nxf ksp pbx rkj zqn
mal: nxf ppa osb urv
sou: kvi cby kuq oht eef
tcw: nyp qew hul nep lvh jsj xoy mwh wkm gbw out wne
hez: tav
gbv: sgi xoy pcc vpw
srw: tav igo lpr lvu eum fuz ges mal bya wqm lof tdd hft joo
puo: jih rtz jqy pcc vpw hlx cfl ges eef sgi zdq iyr fcm esh xoy umy
njq: lvh icu bbg uil xqw lpr mwh lof tpj nxf vni rkj awm
udo: tcw lrs sdz trj
baa: lud bri xft jsv agl tim tav lxa udm fgc zxh bsw
khr: rpz joo vpe hyh whn lnq ass gih vuc ual lud faw
fil: bya lqs itr lxn ivj eij pcc fcm
fnl: tdd fcm hlx lpr xoy cre rfx mwh jjq xqw olf nyp
por: abi rtz ole xgf wkh bzv pbx tue fgc cis fgt kag ujq cme umy
pgr: lvu hmw lqs qwb udm rkj pwr tbp
zqn: yhz pcj qew wru jje jsj ian ksp lhu
olf: esh xoy ges umy iyr eef vpw cfl osb uil hlx pcc
jaw: xoy cge sdz ttg seu agl azy srw lud ksi
lfy: bhs xib tpj alx hul ewl olf jqy gtz ygd
lem: bya orn lxa cmk pog qgm scr zkf gsw jqy
yhz: ffi hft xkl hul oip ian pgl kvi frc jaw oef kad vhr xqw abi ffj
cgd: ujq auw icu cis lvh whn lqs pcc xdo cre tds
xec: seu bel lnq tue hgq oef fcm zat xib lpr
hmo: jcb eef wqm srw ucl qnv kuq tuu gtz
cot: lvu
svr: fft qlo ucq kkv fyi vzn clp
jol: rtz olf jih jqy xoy osb esh uil eef puo tdd oqv cfl zdq
bsp: dgk tdx cea ozf cby zkf aet ewn ues kgz
tue: fnn zdq nqt osn
yfj: vhr qac igo
nbv: bri alx bel wne
zsr: clp zdq ygd alx eqx puo xoy lhu nyp nxf iyr
lpw: xgf lud ujq sbh nqt zcb nyp imi jjq fnb gxk zat nxf
uml: hlx udx dre kvm fwk uil jqx lxn
pin: zsr
fgc: fnb maq vyh mwh sdz tim tdx dli osn fnl
hxk: alx jqx vaz kvi
tkv: nxf kzm iax urw hmw raa lud ydm orn pog tav
ndz: ndn wqq nlu ges lud vzg tre xoy vuh hrh jqk
qnv: nep lvh ppa uet nqt rfx oqv fuz ujq
wqm: fnn hal iyr olf jih eef zsr psr nxf out kuq osb
agp: kag ezn wco svc sgi
whn: hft dwm ole ejd cge osn zcb lhp nxf cfh ova
oht: nep msg ygj nxf
vni: gbw gbv dli cfl
npq: lqd xac dku tdx ges lvu erz lpr jxm zqn rpz
ntf: tds ian smb urv ymk
vkl: ygd ges srw cjt eqx uet ubp
nyp: osb fcm jih cfl hlx eef
tjj: xet smm jcb
ukr: rjd gsw
zxh: nyp lqd rkj joo
jng: mhn olf hez lvu xuj ssi ova cfl kmk hmo yme cme dac puo qnv tem
jeg: pgy vxx jcb nvb azy vgt yrs wne xec
orn: jol jcb xoy udm clp ysz bel vbj lpw xsf vni dwm lxn icu
ygd: iyr abp alx olf hul jol nyp jjq zcb xqw eef
awm: tpj hmw ges lvh bel
vtb: mgf baa nhi maq ylc
zgi: ytp abi
oim: ylc vni njq ppa seu hgq
nxf: puo ujq wkm
nvz: hod tdd
nep: lvh
wbi: xvt
ohc: bel lhp nyp ocr mwh ucq nzj qvd qvc oim xmb olf rkj kag
hzj: mgp ubp jqk nxf spk ucz
tfd: udx has out xsf faw ymk lhu rjd rfx
ucl: msg hgq lud spk cjt wik wqq ssi vuc rkj sus ejd hmw rwh
kzq: ffi agl auz fqd mal nep seu
qtn: ksi clp ygj uoh auz lhu pin chd xec csi vuh bri msg
evd: zdq ujq xec tem pin vyh qwb nxf lpr ylc
jmn: khr sfn pcj hgq csw rwh dly
hpk: kzq ijv nzj luf bxz urv tlp xmb zdq iby xet bsw ltw xfs qew
vea: oqv tjj pgy fwk ajr vtx lxa
jjb: bia xsf tue uet cea qnv tyq kmk kgz ylc jng chd rwc xfs ysz
cby: seu auz vni mwh pbx olf frc lhp
dde: ydm qnv egu efj kuq gqb bsn bng lmc
fnt: zdq
awq: ygd ejd ssl nel wkm lpr dac wqm uxg mhn xfs olf tdd
qgm: tdd wkm zcb njq pgy ewl qew olf igo nyp uxg
sec: jgh tcw csw fnb jmn eij wlu xgf itr pgl ttg mgf erz
fga: qov auz zat ivj tbp ozu tuu
lro: tdx ohc pwr sus gtz qac ucq xet ltw jgh qwm xmi iyr
pgl: mwh nbv sdz xoy cge
xet: alx zmf
xit: orr clp zsr
hal: olf umy bbg
kkv: erz xmi hgq fwr inu oim qac bri
gnq: lst diw pog kwa oip xet tlp bwk bel njq lem rdw lfy khr igo fgc
zkf: cfl jqy clp
rzh: kzq jih
ydm: kzm ksp puo kvm mhn pog nzj ajr qvd dly hmw icu vtx iyr iig mgf
nhi: sfn
qew: xoy rtz fcm tdd oqv esh umy olf
csi: abp alx cjt dli rtz cfl nep ygd gxk bya
xmt: por vac scp ozf yaw gxk sfn ygd jqy kcw
xqw: jqy bya joo rkj ffi vpw ges umy zdq xoy ujq esh jjq
jqk: kzm rtz ova mhn tim esh zdq qew oef eum
itr: tlp fnb nyp osn bxz vkl lud oqv wkm
cmm: tdd
kvi: ttg vuh alx xgf nep azy wik vpw xvt bhs
esh: pcc osb oqv jih jqy hlx rfx zdq xoy
tdx: tpj vhr pcc xkl gtz qnr urv
lmc: tem
brk: oip zat svc awm nxf lxa bya xqw jnr ppa joo cge zxh
lqs: ual tue sus pcc qgm qnv eum cjt
acm: hyh cdj tdd lst bzv fuz rdw ygd
auz: svc vuh icu sdz joo wne cfl osb igo jnr mal xvt kxf fnn osn
kej: abi
urw: nel kag spk tbp ian yrs uil ole oht
uuy: xit abp
pxg: tlp qvd zcb scp puo olf lpr zsr cjt uet igo tcw pgy hdj ueq
gsz: pcj cdj tpj scp bri orn
qnr: jsj alx abp dwm lqd eum zcb mhn kzm cme hmw
tpj: eef nep hft fnn
vac: wqm hgq zcb olf tav vuh jqy dli
dli: zdq xgf hlx vyh gbv lvh nep esh
ttg: bel vuh xvt ksp lrs
lni: cot esh oqv bya udo hrh ygd slh qvd lxn wec jcb jqk
vef: ocr azy itr uet uoh vbj
uhc: wco alx tpj uet
xtm: cme rdw pin fnn hpj fwr orn lvh bhs sec mhn jjq lxa yaw jaw
yrs: gbw lhu pcc xgf lof uil zkf oqv psr fnl jih imi vgt rfx lxa cjf
lof: nqt rfx oqv alx
wkh: kad dku sdz rug lrs ubp
ijv: hzj sbh yan lpt lqd hmw xqw
vtx: out nqt usg hal joo wne nep sfn fcm lpw
ppa: olf cfl fcm jqy joo lpr nyp umy
maq: igo vpe kzm wne ffj zxh fnn xft oip seu lfy
mlb: jsj ewl oim wqm xoy fnl xyk fuz
lhp: rkj rtz fnb bbg umy tcw ygd eum jih ova lof ezn ksp gxk cge jnr
qvc: oip vfa jxm auz jqy jjq ffi xgf
udx: xdo kkv ymk pcy jaw oqv wkm tem ylc msg clp zsr rwh
ove: pqu fnn vgt jaw srw nuh lof luf seu kzm
cjt: zdq lvh ujq abp joo jqy eef rtz osb mhn xqw rfx jih
kca: agl nbv ian qvd acm abi jhh dku ucz mlb zdq ove qac bsw
bzv: xmi iyr jol tcw esh lof tds ffj icu ujq
kgz: qvd zcb igo vez uuy faw pog lpt ewl
wix: gtz orr sdz ueq evd uil lvu
uba: nel
att: ydm
tre: iyr zxh ksp adu
ova: eqx urv jcb gbv alx
ndn: vaz nlu lst umy ual vfa kag rug jjq wkh imi out jol
alx: lpr bel uil abp hmw qew zdq iyr hlx rfx jjq ppa rtz rkj lvh
eum: rfx vpw rtz hlx nxf qvd xgf
dku: usg qxc lfy jih ttg fnb lpr eqx gtz lrs out qct bzv lpw zsr
zdq: oqv pcc hlx xoy
ocr: tim osn wqm hlx tcw ges nyp nbv gbw mhn mwh ssl
lpr: jqy puo esh jih iyr oqv mwh xoy
vaz: ezn sfn uoh cme eef
wne: ppa esh ffi mwh cfl dli cre fnn jih eef osb mhn lvh rtz fcm zdq
pfm: kgz xqw sou zat jol scp uuy vuc
jih: zdq
pcc: hlx oqv jqy
msg: eef dxe ass jmn qct fnl xqw rkj
zsa: sfx
eij: lkv esh luf jih gtz vuh osb ndz
mum: nep ass pcc mhn xib uxg ria maq hgq bia xkl tpj buj
nyu: lmc nsc nvb jgh
ale: gih gxk
weq: lud tvv iby
jnr: pcc sbh hal xft rtz
vxx: por nep wix ass buj zxh gzu dac hul lpt wne xoy kxf
gzu: jol wne lpw hul cge kzq
cre: osb lvh rkj ujq uil pcc umy lpr xoy rtz esh
frc: zdq zcb tue agl osn lxa qnr srw xgf zkf vfa tim
abi: qnv kub out ylc zsr vgt nel lfy ygd sbh jcb kcw
hdj: nep jih xkl pin nyp ppa ejd hul lvh hft lud puo bri eef
ivj: vpe xac tuu nyp ppa
gsw: chd bxz qnr mgf xit maq wco zcb baa pin
jqx: pqu qgm yav svc sgi pin mgf
ysz: fcm xvt osn
sjq: uxh xfs jih vzn mlb vyh gih zsr hft buj seu vfa pog
abp: puo hlx nyp lpr mhn sgi eef cre jih joo fcm nep lvh jol olf
hgq: dli lpr cjt psr iyr ges awm ygd jcb
ztb: cfl qmy xft tre jcb
ecz: ass
zlo: rtz dku ksi bya whn wkm oip jsj fgc vpw chd tav eef ejd cge iyr
bwk: frc ygj xwd ges xfa qgm hlx tpj oht llg vuh vni
zcb: mwh cre uil xoy fcm vpw nyp jol kxf
qwm: uoh pgy ues sjq erj cme urv
pcj: oqv ejd orr imi igo oip tpj zxh
tmi: cfh wkm wru ueq cre nxf vac cjf bxz sus clp xet mhn pgy frc
qvd: rtz vni lof
vpe: xgf lof awm puo lhu cjt eqx nep gxk nyp cme zdq
tuu: kag abi gbw hal ymk slh wqm dbw fgc pcj xkl mwh
vxs: zqn zat mnz lnq zxh yhz alx hmw
txs: pxg oip agl azj diw slh kes ucq
djh: ysz pqu udo npq uil ffi tdd faw igo cby cfl lrs ste nbv
ylc: wqm fuz jsj out dly pin nbv fnl eqx zdq uet eum osn oqv
xaf: ove vfa zyu
yme: spc hft lpr udo cfh msg wko udx sfn hmw
dly: puo fnl
nvl: ttg msg csi svc lst nyp jjq yhz tpj olf jqk
vuh: eum zsr
cmk: kwa azy
rkj: esh uil xoy fcm cfl
hul: fuz bya sgi nep
fiz: fcm maq qag yfj qtv pbx pkt fnl ass
lxn: ysz
jxm: ssl yrs yav zcb ffj lnq rwh nlu dac vgt seu zat
zyu: pcc dwm xkl tpj tue dac bsw bri gbw zkf
nvb: qct rwh tav vaz msg gtz
rvg: psr vkl azy sjq ndn rwh cvt gih hgq tue
ylq: lhu xkl hlu tsz wlu gih
wik: nlu ass oqv csw vni igo uil hmk ocr kub
bsn: yrs rug
gwq: ole qvc
fwk: trj snq maq lxn ubp out ejd tdx yhz qnr hdj abi usg ydm uxg nyp
ozf: out jqy sdz dxe rfx gih rwh cre imi zmf evd kzm xwd
nqt: cfl tdd hlx eef bel zdq fcm kxf oqv rkj abp vpw joo zcb osb jjq
azj: sou udm gtz bia kuq qvd fgt
mgf: lhp abp bxz xvt rtz
nuh: ewl xft rfx hlx tim hft
llg: mhn sbh awq cfh tdx zsr osn oqv tim ygd jih tuu zkf jqk lud brk
cvt: zlo
clp: uil lof lvh cfl mhn vpw fcm
eqx: qew ujq mhn cfl sgi rkj fuz hmw puo ges
mgp: awm esh jsj oip bri osb fnb
rlr: maq pcy ucl
oef: cre oqv esh lud
mnz: xvt pcy oht cmm qxc lst snq
xdo: npq bsw jcb tre njq oef faw zdq iyr gbv
bng: zyu trb
dre: kuq out bel jqk mal rwh pin rug zmf
xwh: zcb jih lvu vni
cew: hmk gzu fga faw pin sbh hxk xmb
vgt: osb olf lvu kxf jjq fnl cge vyh ewl gxk jqy rkj uil clp
pog: uil hmw lvh kub wqm cfh sbh bhs rkj vhr nbv oqv hal csi fuz nqt
has: yhz dtu cby pqu vni wkh abi
bzz: vyy ilc fwk rug law bxz qpc cre jjb tsf out oip qgm
kvm: zat nzj cjt vyh mal zkf pog clp hul hmw xit ewl uxg jjq
aet: osn zed xft lem dxe pgy buj jkh
ked: slh joo vkl faw ndn hmo smb rfx low cvd ndz pyv you jqk
mox: lmc jmm smm lof qpc
out: bel fcm cme vpw rtz fnl bya wne fnb tdd esh gbv jqy fnn kxf
cmb: kmk xqw ejd gxk rug mnz bhs gus lhp vfa
dwm: xib sbh sfn vhr bel
dac: out kvi kvm vac lhu osn hdj joo xib ova ylc hmw pin jsv
fwr: umy dly zsr ohc ueq gbv fuz scp puo ual pog
gih: ass
ucq: ova csw jsv nxf rfx abp maq
mui: whn igo lvh fwr
ltw: maq bri gbw
tng: qwb sec rfx ewn smb jeg ssi zyu sjq trj wlu azy xet
cfh: ygd xib nep
icu: cjt vyh jih jjq
psr: umy qvd jol nyp hmw bri hul zdq rkj gxk cre ygd lof
ies: gnq vuc hez zlo ffi rau tfd fnn nxf csw rug imz urw tcw pxg vxs
dbw: vuc xet cjf sfn qgm xft alx ksp ozf qew ejd jol
fft: dac slh eqx por
oib: vpw ass ylc ocr lvh gtz
jhh: lvh erz xac lhu vgt lpw usg ocr xsf hal osn
sgi: oqv zdq
slp: kej vxx uxh fga inu fnl tlp evd
fcv: ale fuz kvi kej bel yfj jbu rjd qmy fgc tsz brk txo
yaw: mhn ffj trj has upr xwh yke jmm kag xib kej
jkh: jbu xyk maq
fzw: hpk jkh fgc pjc rfx qew dac ste tjj yke sou
lpt: xyk cfl bzv jje spc sfn lnq hlx rdw ohc zdq ewl erz dly uil
hnt: puo yhz tjj kad spw cmm ajr lhu lhp vkl trb uhc ucl lmc gtz luf
hod: pxg jol abi ppa xyk
ole: mwh eef lqd lhp tdd wqm eqx azy hal yrs osb
vez: pcj ass xge voo lrs zxh
cfl: jqy xoy sgi vpw pcc zdq osb umy hlx jih esh oqv
gqb: yan zyu qct lct wko zmf hod srw
xoy: osb jqy hlx pcc oqv
lqd: bya qew fuz ewl dli icu zcb
cxd: qxc nvl vzg alx pcc icu tcw lmc dre ecz hmk kzq jsv azy rau olf
gus: agl zyu hmw usg cme xmi eef ygj
ffi: osb nep cfl jih lpr zdq oqv alx puo ujq sgi olf
ejd: lvh bel zkf kuq alx
vpw: xoy jih rfx pcc osb hlx zdq oqv jqy esh
